naruhodona -- понимаю

arienyo -- ни за что

so(tsu)ka -- понимаю

osanazuma -- невеста (?)

monogatari -- история, сказка

doa (w)o akeru -- Я открываю дверь

tadaima -- я дома

okaeri (говорят в ответ на предыдущую фразу) или okaerinasai (более вежливая форма)

i(tsu)tekimas(u) -- я иду (я ушёл) (я ухожу), им отвечают "i(tsu)tera(tsu)sh(i)(y)ai" (иттерашай)

kutsu (w)o nugu -- я снимаю обувь

kutsu (w)o soroeru -- я надел туфли

kutsu (w)o haku -- я ношу обувь

kutsu himo (w)o musubu -- я завязываю шнурки

sof(u)a ni suwaru -- я сижу на диване (софе)

ashi (w)o kumu -- я скрещиваю ноги

ude (w)o kumu -- я скрещиваю руки

rimokon de terebi (W)o tsukeru -- Включаю телевизор пультом

ch(i)yanneru (w)o kaeru -- я переключаю канал

terebi (w)o kesu -- я выключаю телевизор

sumaho (w)o j(i)(y)u(u)densuru -- я заряжаю свой смартфон

sumaho -- смартфон

sumaho wa {ha} suma-tof(u)on no_koto des(u) -- "сумахо" - это смартфон (катакана)

futa (w)o akeru -- я окрываю крышку

k(i)ya(tsu)pu -- крышка (другое название, видимо связанно с кепкой)

k(i)ya(tsu)pu (w)o otosu -- я снимаю крышку (кепку)

k(i)ya(tsu)pu (w)o hirou -- я поднимаю крышку (кепку)

mizu (w)o no_mu -- я пью воду

futa (w)o shimeru -- я закрываю крышку

pasokon de benkiyo(u)suru -- я учусь на своём компе (пасокон - по видимому, комп (катакана)) (de - использование чего-либо (компа))

megane (w)o hazusu -- я снимаю очки (megane - хирагана)

megane (w)o fuku -- я протираю очки (megane - хирагана)

megane (w)o kakeru -- я ношу очки (megane - хирагана)

manga (w)o yomu -- я читаю мангу (заметка: она читала "COJI-COJI")

utoutosuru -- я засыпаю (задрёмываю)

ara-mu (w)o se(tsu)teisuru (mezamashi (w)o se(tsu)to suru) -- я ставлю будильник

hirunesuru -- я вздремну (посплю)

ara-mu (w)o tomeru (mezamashi (w)o tomeru) -- я выключаю будильник

me (w)o kosuru -- я протираю глаза (канджи "me" (глаза) - выгладит как этажерка)

akubisuru -- я зеваю

nobiosuru -- я растягиваюсь (потягиваюсь)

ha burashi ni ha migaki (w)o tsukeru -- я наношу зубную пасту на щётку (burashi - по видимому щётка) (ha - зуб?)

ha (w)o migaku -- я чищу зубы

kuchi (w)o yusugu (kuchi (w)o susugu) -- я полоскаю рот

kontakuto renzu (w)o tsukeru -- я ношу контактные линзы (можно без "renzu")

burashi de kami (w)o tokasu -- Расчёсываю волосы щёткой

hea oiru (w)o kami ni tsukeru -- я наношу масло для волос на волосы

hea gomu de kami (w)o musubu -- я завязываю волосы резинкой

kesh(i)(y)o(u)suru (meikusuru) -- я делаю макияж (так же макияж называют "meiku")

piasu (w)o tsukeru -- я ношу (надеваю?) серьги

shiawase -- счастливый

fuorowa- -- фоловер (подщипчик)

gu(tsu)bai wa-rudo -- goodbye world (прощай мир)

matane -- до скорой встречи

Oto ga ki -- привет



Примечание: частица "(w)o"  как бы придаёт предстоящему глаголу винительный падеж, а частица "de" - творительный (или родительный)

